00000000000000000000
00000000000000000000
00000000000000000000
00000000000000000000
00000111111000000000
00000000000000111000
00000000000000000000
11111100000G00000000
00000000001111000000
00000000000000000000
00011110000000000000
00000000000000011111
P0000000000000000000
11111111111111111111